x = 27 y = 14
x = 28 y = 13
x = 28 y = 14
x = 28 y = 15
x = 29 y = 13
